0,0,0,0,0,0,0,0,0
0,395,81,230,268,405,364,361,379
0,735,311,557,262,162,178,242,228
0,319,90,297,131,136,78,321,226
0,130,187,172,210,189,80,207,133
0,199,366,322,228,241,278,268,199
0,160,189,266,165,211,296,396,298
0,144,412,557,172,103,264,262,184
0,153,650,614,219,78,356,319,201
