[
  [0, 0, 0, 0, 0, 0, 0, 0, 0, 0, 0, 0, 0, 0, 0, 0, 0, 0, 0, 0, 0],
  [0, 1, 2, 3, 4, 5, 6, 7, 8, 9, 0, 0, 0, 0, 0, 0, 0, 0, 0, 0, 0],
  [0, 2, 4, 6, 8, 10, 12, 14, 1, 3, 5, 7, 9, 11, 13, 15, 0, 0, 0, 0, 0],
  [0, 3, 6, 9, 12, 15, 3, 6, 9, 12, 15, 3, 6, 9, 12, 15, 0, 0, 0, 0, 0],
  [0, 4, 8, 12, 16, 4, 8, 12, 16, 4, 8, 12, 16, 4, 8, 12, 16, 0, 0, 0, 0],
  [0, 5, 10, 15, 4, 9, 14, 3, 8, 13, 2, 7, 12, 1, 6, 11, 0, 0, 0, 0, 0],
  [0, 6, 12, 3, 8, 14, 5, 10, 1, 7, 13, 4, 9, 15, 6, 12, 0, 0, 0, 0, 0],
  [0, 7, 14, 6, 12, 3, 10, 1, 8, 15, 6, 13, 4, 11, 2, 9, 0, 0, 0, 0, 0],
  [0, 8, 1, 9, 2, 10, 3, 11, 4, 12, 5, 13, 6, 14, 7, 15, 0, 0, 0, 0, 0],
  [0, 9, 3, 12, 6, 15, 9, 2, 11, 4, 13, 7, 0, 9, 3, 12, 0, 0, 0, 0, 0]
]
